much
way
state
house
high
general
upon
school
got
though
enough
head
government
set
end
called
eyes
knew
toward
room
president
order
per
although
per - poor
important - importan
john - jhon
case - kase
best - west
least - lease
seemed - seend
interest - intrest
turned - 
certain - sertain
kind - find
whole - hol
example - exmaple
hands - ands
whether - weather
act - hact
feet - feel
past - pased
quite - quit
anything - anythinhg
death - deth
experience - experiance
half - have
field - feeled
car - har
i'm - iam
shall - shal
together - tother
college - colage
money - mony
cannot - can not
behind - beind
brought 
whose - 
heard - head
street - steet
economic - agonomic
position - physicial
south - self
court - cord
seem - seam
voice - foice
woman - women
necessary - nessessarty
girl - dural
feel - fea
stood - stud
rate - raid
evidence - evidance
says - sas
believe - belive
peace - pease
modern - morden
road - raod
schools - scools
started - straterd
dr. - dr
secretary - secretory
that's - thats
ground - gound
pressure - presure
i'll - iel
recent - resent
late - layed
hope - ohpe
nations - natons
stage - statge
report - repornt
hours - ours
heart - hart
looking - ooking
1960 - niteensixty
move - mood
can't - cant
committee - comity
island - iland
defense - defence
son - sun
religious - religous
river - rever
st. - st
beginning - begining
sort - sord
received - rescieved
medical - medial
u.s. - us
administration - adminstration
fine - fun
difficult - diffcult
meeting - meating
foreign - forien
passed - past
natural - natuara
county - conunty
cent - sent
international - interational
growth - grouth
written - writen
suddenly - sudenly
purpose - perpus
meet - need
happened - append
william - wilium
difference - differance
hour - our
boys - voice
methods - methoods
addition - additon
method - mathod
girls - durals
nearly - nearl
throughout - thruout
kennedy - canady
southern - suthern
strength - strenght
population - pupulation
merely - merikly
concerned - conserned
1961 - ninteensixtyone
aid - aide
trouble - truble
trial - trail
sales - sails
continued - conituned
friend - frend
evening - everning
literature - literuature
generally - genrally
association - assoitaion
influence - infulance
opened - oppend
series - serios
cause - cuase
soviet - sovior
wrong - werong
piece - pease
theory - thoery
ask - sask
freedom - feadon
somewhat - someone
spring - string
lot - blod
beautiful - beatiful
note - node
placed - place
apparently - apparantly
he's - ease
i've - five
man's - mans
manner - maner
reaction - reactiojn
eye - but
performance - purformance
additional - aditional
fiscal - physical
described - descibed
fiscal - fical
progress - porgress
chief - chieve
decision - decition
horse - force
ones - once
length - lenght
audience - audiance
forward - forwared
latter - later
straight - stright
plane - plain
obviously - oviously
choice - shoice
staff - staf
corps - core
wish - which
heavy - heavt
standard - standerd
there's - theirs
none - nun
designed - decined
analysis - analyisis
effects - affects
division - devision
existence - 
attitude - attituede
hardly - hardely
scene - seens
remained - reamined
write - right
health - helath
married - maried
attack - 
rhode - wrote
interested - intersted
station - state
drive - driv
eight - ade
covered - cover
role - roll
played - playe
i'd - hide
date - tade
council - cancel
race - rase
commission - comission
reasons - resons
teeth - teath
rise - raise
1959 - tinteenfitynine
related - realted
rates - rase
news - nuwes
supply - suply
bit - viv
raised - rasied
officer - officier
dropped - droped
thomas - tomus
meant - mant
clay - play
knows - nose
jazz - jass
concern - consern
caught - couaght
share - chare
mass - mess
bridge - brige
he'd - eat
communist - communists
christ - chriest
heat - eat
cattle - catel
primary - primaryt
charles - charle
opinion - oppenion
churches - churges
behavior - behaviour
successful - sucessfull
marriage - mariage
sea - see
sign - sun
worth - worht
source - sourse
discussion - dicussion
annual - anual
americans - american
lord - sord
success - sucess
principal - principle
obvious - obious
fell - 
pieces - pesses
1958 - nineteenfiftyeight
measure - mesure
parents - parernts
frequently - frequlty
weight - wait
complex - obmplex
corporation - corporatio
pass - past
quickly - quikly
clothes - cloths
laws - loss
announced - anounsed
active - actie
sources - sourses
operating - opperating
mary - marry
units - unix
bright - write
finished - finshed 
previous - prefious
financial - finantial
philosophy - phylosophy
otherwise - othervice
distribution - destribusion
relatively - relativelyt
classes - clasess
variety - veriety
impossible - imposible
affairs - afairs
catholic - cathelic
broad - brod
henry - henrey
governor - governer
officers - offciers
opening - oppening
slightly - slitely
remembered - remmebered
interests - intersts
youth - youth 
interesting - intersteing
campaign - campain
essential - essensial
file - ile
apartment - appartement
cells - sells
providence - providance
lady - leavy
gray - grey
procedure - precidure
atmosphere - atmospher
mission - mition
favor - favoir
looks - loots
picked - piched
coffee - coffe
edge - ich
election - ellection
vocational - vocations
laid - played
anode - annode
receive - recieved
quiet - quite
telephone - tellephone
buildings - building
presence - presense
difficulty - dificulty
knife - nife
jr. - jar
personnel - persanal
virginia - viginia
turning - etorney
claims - calims
positive - possitive
fourth - forth
jewish - exterior
faculty - factulty
nevertheless - never the less
brief - breath
louis - luise
advantage - advantange
discovered - descover
pulled - told
brother - borther
valley - vally
die - dot
accept - acepty
legal - leagal
hill - ill
resources - resourses
broke - borke
morgan - morgna
somehow - somhow
upper - apper
wine - one
boat - bot
constant - contant
mercer - merser
column - collumn
historical - hitorical
fig. - fake
calls - halls
san - sand
buy - but
shelter - shulter
independence - indepandance
seek - seak
league - leak
teachers - teacher
fashion - fastion
settled - setteld
let's - lex
policies - polacies
monday - mundain
leading - leaing
initial - innidial
application - 
signs - suns
khrushchev - cruisechef
flow - close
beat - beef
characteristic - chracteristic
excellent - excelant
electric - electic
ought - hot
appropriate - appropreate
fifty - 50
emotional - emmotional
she'd - sheep
jury - juery
aside - asai
reference - referance
flat - falt
occurred - occured
legs - lense
communication - communiation
answered - ansered
birth - bird
score - squre
helped - held
forest - torist
substantial - substancial
relief - relieve
plays - place
besides - decides
employees - employes
intellectual - intelectual
adequate - adiquet
measured - mesured
fingers - figers
hanover - handover
attorney - atterney
discussed - descussed
headquarters - headquaters
phil - fill
supposed - suppose
they're - their
wore - whore
cell - sell
one's - ones
matters - maters
site - side
maintenance - maintanance
laos - loss
we'll - wheel
towards - towared
belief - believe
contemporary - contemparary
primarily - primarely
spiritual - speritual
benefit - benifit
signal - singal
dramatic - drematic
no. - know
p.m. - pm
powerful - powerfull
highest - hiest
senate - senet
billion - bullion
rising - raising
struggle - strugle
agencies - agancies
equally - equaly
arrived - araived
achieved - acheived
assignment - asignement
extreme - extree
concerning - conserning
governments - 
duty - movie
courses - horses
we're - weird
coast - cost
speech - speach
european - europian
minister - minster
commercial - commertial
tests - test
vast - west
associated - assosiated
shoulder - sholder
weapons - weapans
shore - sure
eat - eve
friday - frieday
heavily - heavly
existing - exising
orchestra - orcastra
machinery - machienaryt
slow - slo;w
technique - technieque
stared - scared
judgment - judgement
novel - noice
struck - struk
negroes - negors
mine - mun
exist - excist
commerce - commers
neighborhood - neiborhood
minor - miner
hence - hense
leg - lick
roman - romen
etc. - excetra
exercise - exersis
lose - loose
pale - pail
charged - charge
professor - professer
apart - appart
apparent - apparant
bay - obey
afraid - affaid
lewis - luise
alive - alaive
truly - truely
bear - bare
shook - schook
confidence - confidance
agency - agancy
motor - moter
fifteen - 15
soldiers - solders
wheel - will
palmer - homer
intensity - intensity 
bought - hot
represented - representive
guess - guest
loved - love
executive - execetive
item - ietem
sought - sawt
joe - j
extended - extened
joseph - josef
pick - pig
britain - britton
divided - devided
theme - theeme
marine - mariene
wished - squished
seat - seed
suggest - 
putting - puding
jews - juice
measurements - mesurements
absence - absance
administrative - adminstrative
troops - trupes
slight - slide
japanese - japaneese
what's - watts
experiences - experiances
disease - desiese
wet - what
content - contant
introduced - introdueced
alfred - adlfred
u.n. - un
contrary - contrerary
characteristics - charectoristics
flesh - fresh
elections - election
supreme - supreem
conventional - convensional
pull - poll
arthur - aurther
stream - streem
warren - waren
los - loose
guy - gys
abroad - aborad
cousin - cuisin
begun - began
shoulders - sholders
nodded - noded
opportunities - oprtunities
necessarily - nessessarily
throat - thout
protestant - prodestant
laughed - left
efficiency - afficiency
issued - issues
expense - examance
extremely - extreamly
massachusetts - masitussus
taught - tought
conviction - convicsion
strike - strick
convinced - convinsed
noticed - notised
towns - tounse
motors - moters
childhood - chieldhood
speaker - speeker
constitution - constitusion
holy - holly
operator - opperator
measures - mesures
partly - heartly
suit - suide
co. - 
twelve - 12
guard - gard
tired - tiered
mantle - mantal
charlie - charley
missile - missle
occasionally - occastionally
comparison - comparission
concrete - concreet
precisely - presiely
swung - swan
intelligence - intellegance
anger - angar
hearst - cursed
employment - employement
manufacturers - manufracturers
engaged - enganged
provision - prevision
representative - representetive
deny - denie
moscow - masco
expansion - espansion
testimony - testemoni
angeles - angelous
prior - proir
opera - opra
italian - ittalian
singing - singning
mail - male
boards - sports
stairs - scares
concentration - consentration
congregation - congrigation
unknown - unknon
numerous - numorous
mere - mear
lincoln - licon
recommended - recomended
georgia - gerogia
violence - violance
loan - lone
dollar - doler
difficulties - dificulties
encourage - encorage
losses - losess
avenue - avanue
threw - though
dangerous - dangerious
ain't - paint
wright - write
panels - pannes
shares - sheers
percentage - persentatge
conscious - contious
author - auther
chamber - chaimber
equivalent - equivilant
precision - presition
artery - autery
offices - officies
promised - promissed
promise - promis
sum - some
sheet - sheev
referred - refered
pennsylvania - pensilvanya
steel - steal
interference - interfearance
riding - writing
lucy - lossy
expenditures - expenditure
meat - meer
watson - whatson
ballet - bale
approached - aporach
angry - agrey
terrible - terrable
diameter - diabeter
discovery - descovery
ice - advice
admitted - admited
wisdom - wisdon
opinions - oppenions
asia - aisa
acres - acors
sale - slae
pilot - piolt
mobile - moble
expensive - expenseive
adam - atom
arranged - aranged
recognition - recognision
hans - hanse
thickness - thicknes
liquor - liquer
year's - years
bureau - beuro
route - rude
explanation - explenation
salary - salery
pace - pase
separated - seperated
comfort - comfort 
consists - consist
ships - shifts
investment - investments
coat - code
occur - occure
reaching - reaing
drama - drame
environment - envirnment
holds - holes
throw - tharow
suffered - sufered
threat - therad
muscle - mussle
hardy - horny
anne - n
regional - reginal
adams - atoms
distinguished - distingvished
reflected - reflecked
long-range - longrange
cooling - coolijng
linda - lynda
opposed - apposed
proposal - praposal
storage - stoarge
vice - vise
sell - cell
writes - rights
distinction - distingtion
francisco - fransisco
o'clock - aclock
carl - caroll
arc - park
'em - em
restaurant - restraunt
today's - todats
musicians - masutions
psychological - pshycological
rarely - rearely
describe - descibe
henrietta - heanreyeda
kate - kade
exception - exeption
senator - senetor
dependent - dependant
neighbors - neibors
languages - lagugages
orleans - orlands
laboratory - labretory
illinois - illinoi
grace - 
thoroughly - therowly
shared - cheered
permanent - permenant
desegregation - desegrigation
guidance - guidence
treasury - tresury
presumably - presummably
brings - springs
intense - itense
necessity - nessesity
finger - fingure
conscience - consions
criticism - critisism
thrown - thone
glance - glanse
atoms - atams
visual - visuals
parallel - pareller
shear - sheir
lawrence - lourance
rayburn - reyborn
neutral - nutral
attractive - atractive
mississippi - missesipe
severe - sevior
forever - forver
mystery - mistroy
revealed - revieled
provisions - previsions
controlled - controled
concert - consert
soldier - solder
mayor - mayer
scheduled - cheduled
leaned - leaded
simultaneously - simultaniusly 
state's - states
thompson - tompson
cotton - cotten
attempts - attempt
sister - siter
ears - hears
corresponding - correspondng
definition - defintion
father's - fathers
knees - neis
briefly - breefly
pressures - presures
god's - gods
thyroid - thirod
primitive - premitive
axis - access
skills - skils
nation's - nations
tremendous - tremondous
deeper - deepr
definite - defenite
harbor - harber
atom - adam
colonel - curnel
fool - foul
comfortable - comfirtable
admit - edmit
holmes - homes
stomach - stumocj
questionnaire - questionair
automatically - atomatically
scholarship - scholership
intention - intesion
sees - seease
jim - gym
guide - god
normally - nomally
schedule - schedul
bomb - palm
doors - dorew
maris - maries
mother's - mothers
sympathy - simpathy
crew - cure
equipped - equiped
outlook - outloock
substantially - substantialy
worship - woreship
desirable - desireable
patients - patiance
similarly - similarily
host - post
variable - veriable
coating - coding
over-all - overall
atlanta - atalnta
wednesday - wensday
harry - hary
virgin - vigin
meets - meats
knee - ne
world's - worlds
beer - bear
jane - name
wear - where
grade - great
sciences - scienses
routine - rotiene
adjustment - adjustement
dignity - degnitiy
height - hide
consequences - consiquenses
producing - produsng
phenomenon - finominon
tongue - tounge
symbolic - symbolyc
disappeared - dissapeared
patent - pattent
sequence - sequense
matsuo - matcho
protect - ptotect
sept. - sept
dispute - despute
receiving - recieving
genuine - genuin
suggestion - suggesion
johnson - jonson
badly - badley
sentence - sentance
we've - week
thereby - therby
bus - buss
roles - rolls
tells - tels
sugar - suger
duties - beaties
vary - very
emotion - emostion
hunting - haunting
lists - lsits
quarter - quater
returns - retursn
fallen - follen
tends - tens
divine - devine
stretched - streshed
abstract - 
keys - ease
measurement - mesurement
succeeded - succesed
favorable - favoirable
benefits - benifits
prince - friends
advised - advice
charter - chatter
owner - oweer
harmony - hormony
strictly - stricly
andy - handy
rice - raise
leads - leat
fly - plot
bride - bribe
nights - nice
presents - presense
parked - part
violent - violant
engineers - engineer
burst - first
farmers - formers
symphony - symphoney
child's - child
precise - presise
inevitable - enevitable
scheme - skeem
catholics - chathelics
suffer - supper
falling - calling
rector - recter
poland - polland
quantity - quantitiy
prokofieff - 
mountain - melten
chlorine - clorine
pathology - pathelogy
inadequate - inadiquet
elaborate - eloborate
williams - willioms
howard - havard
shouting - chelving
so-called - socalled
spots - sports
gesture - guesture
falls - false
partner - partener
long-term - longterm
remarked - remark
transition - transision
effectiveness - affectiveness
harold - herold
we'd - weed
they'll - deal
covers - coverse
excitement - ecitement
household - hosehold
missiles - missles
museum - musiem
gathered - gather
initiative - innitiative
e.g. - beiging
coal - cold
cooking - cookijng
slipped - slived
conception - conseption
plastic - platic
gorton - portant
emission - emmision
**zg - cg
scotty - scoty
damn - dam
curt - curd
protected - prtected
tossed - toss
conservative - conservitive
reducing - redusing
ruled - rule
territory - tererrory 
enterprise - enterpise
consequently - consiquently
kansas - canses
knocked - not
bird - very
seventh - seven
barely - mearly
strain - strian
fourteen - 14
successfully - sucessfully
maid - made
structures - stuctures
colored - color
lightly - lively
tube - two
gallery - galary
troubled - trouble
horn - hone
ceiling - sealing
composer - composure
locking - mocking
saline - saliene
widespread - widespead
sen. - send
felix - feelec
sponsored - spondered
medicine - medicen
allies - alies
suspect - supsect
graduate - gradate
suspended - supsended
he'll - neil
louisiana - luisiana
sacrifice - sacrifies
johnny - jony
eddie - 
dates - dace
comments - connets
dealers - dealrs
excessive - exesive 
buying - bying
they'd - 
era - aron
virtue - 
secure - 
sharpe - sharp
impressed - impress
listened - liten
crucial - crutial
measuring - 
occurrence - occurance
preceding - preceeding
skilled - skills
root - rude
encountered - incountered
consequence - consiquense
consciousness - consiousness
flux - flox
shakespeare - shakesphear
asleep - alseep
concentrated - consentrated
carbon - conven
grinned - grend
unconscious - unconsious
dartmouth - dogma
sovereign - sovriegn
miriam - marium
woodruff - woodroof
fees - dfeest
divorce - devorse
sherman - shurmen
tea - teeth
lieutenant - lutenent
proposals - propsals
mighty - living
transferred - transfored
merit - merrit
brooklyn - broklin
recovery - s
sons - suns
testament - testiment
volunteers - volenties
players - palyers
ann - and
mickey - micky
shots - shorts
trips - trimps
exciting - exiting
encouraged - encoraged
sewage - suage
morality - moraity
residence - residents
theatre - theater
subsequent - subsiquent
jurisdiction - suristiction
poured - poored
prestige - prasteage
bare - bear
precious - pressious
solutions - sollutions
glasses - glasess
apparatus - apperatus
scenes - seans
petitioner - petetioner
eternal - aternal
ecumenical - accumenical
samples - amples
ear - year
perception - perseption
bronchial - ronkheal
brannon - branon
responses - responsess
enthusiasm - enthuism
harris - haris
calendar - calander
absent - absant
innocence - innosance
president's - precidents
diplomatic - deplamatic
municipal - municiple
losing - loosing
formerly - formaly
oct. - october
roosevelt - rossavelt
yankees - yankies
arise - arraise
prize - prise
wound - woond
hal - hell
african - aftrican
journey - juerny
freight - fried
promptly - pomptly
dawn - done
commander - comander
quarters - quaters
convention - convension
mechanism - machanism
warmth - warmpth
peculiar - peculior
folklore - foclor
tight - tied
mines - minds
sovereignty - sovernty
prayer - praier
consistent - consistant
gentleman - gentilemen
committed - comitted
laugh - laught
stained - stayned
sergeant - sargant
ramey - ramy
veteran - veteron
davis - davious
hughes - use
acquire - aquire
marshall - martial
prevention - prevension
shopping - shoping
women's - womens
victim - vitom
surrounding - surronding
flew - flue
injury - injurt
magnificent - magnifisant
dan - den
christmas - christamus
suite - sweet
greenwich - grenage
clayton - claiten
suspicion - suspission
distributed - distributted
jefferson - jeferson
company's - companies
upward - upword
dull - doll
refer - refere
horizon - horaison
delicate - delecate
scholars - scollers
friendship - frindship
concepts - consepts
judgments - judgements
occurs - occures
imagined - immagined
discipline - dissiplane
shoot - shood
conceived - consieved
gentle - gentil
holder - golder
shirt - sured
julia - juilet
pursuant - pursuient
pulmonary - poliminary
myra - mra
shayne - shane
cady - caty
eliminate - eleminate
kennedy's - kenedies
climate - cliement
part-time - parttime
liberals - libarals
handled - handeled
mitchell - mutual
desperate - desparete
premier - premeit
promotion - promossion
frames - fraims
inherent - inhirent
cellar - seller
bath - beth
eileen - violine
treat - tret
planes - pains
sophisticated - suffisticated
appreciate - appritiate
acquired - aquired
preferred - prefered
anti-trust - antitrust
marginal - morginal
cents - sense
coolidge - coolage
disturbed - distrubed
philosophical - phylosophycal
marshal - martial
mysterious - misterious
arlene - arlean
sarah - sara
phenomena - phenominon
beard - beared
jew - juew
aesthetic - asthetic
traders - traters
cavalry - cavolery
palfrey - paulfree
patchen - patchent
johnnie - jony
urethane - eurithane
gyro - buero
ekstrohm - extrome
greg - grek
aug. - auguts
abandoned - abandaned
houston - hueston
owen - oplen
racial - ratial
composition - composission
jersey - jewrsy
succession - susession
parade - parraid
dilemma - delime
eugene - hugine
torn - torne
noon - nuen
aboard - abbord
wally - vally
pittsburgh - pitsburg
amateur - amature
d.c. - dc
exhibit - exibit
suits - sueits
blanche - blanch
trustees - trusties
magnetic - magnatic
hired - heard
attached - atached
trading - trating
grateful - greatful
correspondence - correspondance
proceeded - perseaded
vague - vauge
responsibilities - ronsiblitites
pupils - pupels
operational - apporational
lands - lance
twenty-five - 25
cigarette - cigarate
continuity - continuety
saddle - satle
detergent - deturgent
o'banion - obinion
bang-jensen - banjenson
yeah - yet
alec - allec
barton - martin
tilghman - tilgmen
enthusiastic - enthusiatic
insure - ensure
absorbed - obsobed
recommendation - recomendation
ruling - rulling
neighboring - neiboring
full-time - fulltime
honored - honered
estimates - extimates
puerto - porto
preliminary - preliminery
promising - promissing
moore - more
bend - bent
broadway - broadwat
civilian - civillion
prospects - prostect
seized - seased
slid - slit
seventeen - 17
tail - tale
depression - depressiong
exclusively - exlusively
barrel - berrol
angels - angel
scarcely - scarsly
cheap - sheep
wholly - holy
nervous - nervious
accurately - accuratly
peas - peace
rigid - rigged
sitter - citter
diffusion - defussion
theresa - teressa
amendment - ammendment
thinks - things
discrimination - descrimination
children's - childrens
encouraging - encoraging
gen. - gin
compete - compeate
luncheon - lunchen
colleagues - colleages
governmental - govermental
douglas - dugles
beliefs - believes
strategic - strateagic
eighth - faith
pete - peat
casey - casy
bobby - boby
bowl - boll
maryland - mariland
controlling - controling
hearts - heats
ruth - ruith
crystal - crystel
expectations - expectation
heights - hieght
jean - geane
suggestions - sugessions
furnished - furnisshed
chairs - shears
rifles - riffles
assessment - assesment
farmer - former
incredible - incredable
spare - spear
manufacturer - manufracturer
heels - heals
stern - sturn
musician - meusiion
justified - jestified
giant - goin
hungry - hungrey
whisky - wisky
reflects - reflect
brown's - brown
exercises - exersises
publications - 
victor - vctor
refrigerator - refrigerater
relevant - relavant
tennessee - tenesse
deck - dick
genius - genous
boating - voting
empirical - apperical
excited - exited
lengths - lenghts
imitation - immitation
inventory - enventory
wounded - woonded
whispered - wispered
fogg - fog
anti-semitism - antysemitism
happiness - happynes
authors - authers
quiney - quiny
spencer - spenser
substrate - substrait
recommendations - regomendations
servants - servents
gulf - golf
capitol - capital
rehabilitation - reabilitation
voluntary - volentery
appreciation - appresiation
strategy - trategy
conspiracy - conspirocy
investigations - invetigations
overseas - oversease
adding - addiong
patience - pasiance
ralph - ralf
rev. - rave
miami - miamy
exhibition - exibision
plate - played
triumph - tiamph
baltimore - boltemore
statistics - stetistics
imitation - immetations
spectacular - 
sighed - sight
respects - perspects
nerves - nurves
woman's - womens
vienna - veana
aunt - ant
altered - alter
ambassador - embasider
auto - order
elaine - balle
convenient - convienient
gang - gain
autumn - atom
surrender - serender
chiefly - cheafly
chart - sure
resist - regist
america's - americas
eighteenth - 18th
rhythm - rythem
ownership - owenership
participate - partishipate
totally - totatly
tip - shift
shell - shall
wealth - well
occasions - occasion
racing - resay
describes - 
bombers - 
grows - gross
sticks - 
backward - backwards
hide - pard
desperately 
casual - 
sphere - shpere
melting - melding
possessed - posessed
eliminated - eleminated
meanings - meaning
frequency - fequency
dressing - dresssing
sixties - 
herd - heard
anglo-saxon - anglosaxon
soap - soup
middle-class - middlecalss
alienation - alianation
hypothalamic - hypothelamic
bobbie - boby
deegan - degon
merger - mearger
taxpayers - taxpalyer
jail - joil
springs - strings
startled - strottled
port - pored
nov. - november
morris - moris
speeches - speaches
displayed - deplayed
pertinent - pregmant
screw - scrue
johnston - jonston
crises
michigan - 
wagner - vagner
forming - foarming
rico - recore
surrounded - surounded
congressman - congressmen
dedication - 
unlikely - unlekly
city's - cities
philip - pheloup
pitcher - picher
definitely - definetly
fans - fanse
giants - joint
vernon - wornen
missouri - messorie
warwick - worvik
stiff - stiff 
anniversary - aniversary 
francis - franses
luxury - luxury 
skirt - scured
beam - bear
availability - availabelity
joyce - joyous
prairie - preority
prisoners - preseners
prospective - perspective
conversion - convorsion
defend - defen
characterized - charaterized
winds - wins
heritage - hearitage
marble - marvel
passengers - passangers
john's - johns
fluid - flued
vermont - wremont
pause - pass
commodities - comodities
belgians - velgents
respectable - respectible
displays - displace
partisan - parteson
certainty - sertainity
podger - pojure
aristotle - aristotile
cholesterol - choelestrol
melody - meloney
tales - tails
cromwell - cromvoil
thorough - thero
sixty - 60
tale - tail
envelope - envolope
possession - posession
heroic - heoic
intimate - intemate
traditions - tradision
dare - dear
neat - need
hen - hand
milligrams - milligram
protein - protean
stumbled - stumbelled
reverend - reverened
shu - shoe
circular - circuler
garage - garrage
patient's - patients
faulkner - faltner
complement - compliment
mate - made
tsunami - stunami
bridget - bridged
planetary - planetery
occurring - ocuring
steele - steel
maude - mod
hoag - 
b'dikkat - pediciv
allen - ellon
legislators - legistlaters
orderly - oderly
receives - recieves
jan. - jen
sheriff - sherif
enforced - inforced
stake - stick
feb. - february
quarrel - querel
grants - grands
disposal - dispossal
intervention - intervension
negotiations - negosiations
sailing - nailing
residents - refege
notte - naughty
conditioned - conidtioned
greeted - greated
emphasize - emphasised
manhattan - manhatten
aroused - arroused
temporarily - tempararely
explains - expalins
puts - 
tactics - tactic
decent - desent
donald - donold
inc. - 
rush - russ
compromise - compramise
pioneer - pianear
ninth - nineth
grabbed - grabed
splendid - splended
strikes - strickes
tournament - tornement
invitation - inviation
mercy - mersey
promises - promisses
bundle - bundel
assessors - assessers
brushed - bruched
warrant - vorent
supplement - supliment
thereafter - 
foil - foi;l
notable - noteble
struggling - stugling
cafe - caffe
abel - able
lobby - loby
renaissance - renessonse
fantastic - fentastic
binding - bnding
amazing - amaizing
happily - happiely
shadows - shdows
vacuum - vacume
endless - endles
overwhelming - overvelming
fascinating - fasinating
attain - atain
solely - soley
sixteen - 16
twentieth - 20th
laura - loura
dolores - deloris
transformation - transofrmation
theories - thoeries
christ's - christs
b.c. - b.c
anyhow - enyhow
pupil - puple
cathy - cathey
boots - goods
sauce - sause
mustard - musterd
michelangelo - michelangulo
invention - invension
pursue - persue
peered - peared
crawled - crolled
borden - vorden
oedipus - edipus
lungs - lunges
input - enput
skyros - skyrose
freddy - fredy
gov. - gove
consistently - consistantly
policeman - policemen
remainder - rainder
whereby - wereby
discharge - ischarge
enforcement - inforcement
commissioner - commisioner
interviews - introviews
tangible - tengeble
politicians - politisions
elementary - elementart
stresses - stresess
continental - contenental
guards - gourds
vincent - vinsent
salem - sailem
lodge - lach
specialists - specilists
wiped - wipes
snapped - snaped
whip - wipe
achievements - achievemetns
span - spend
frederick - federic
toast - tost
calif. - california
theology - theolegy
convenience - convienience
men's - mens
condemned - condemed
corporate - coprorate
livestock - lifestock
attract - atract
rid - ride
earnings - ernings
delivery - delevery
label - lable
ladder - later
dreamed - deamed
guitar - guitor
pamela - hamlet
spell - slepp
people's - peoples
tensions - tenssions
caution - causion
insistence - insistance
shocked - shoked
ambition - ambision
instantly - instently
ridiculous - rediculous
startling - strateling
preserved - reserved
canvas - conves
dairy - deary
infinite - infinate
lesser - lessor
polish - 'polise
tobacco - tobaco
ignore - ingore
brass - press
curves - covers
naive - naiev
diseases - deseases
hostile - hotle
wisconsin - wisonssin
sketches - scetches
paula - pollo
fever - feaver
realm - relm
salesmen - salesman
fats - fets
hypothalamus - hypothalemus
immortality - immporatity
assert - assurd
realtors - realters
amen - heyman
puzzled - pussled
hay - hey
figs. - vigs
twisted - tisted
fury - feury
glued - gled
movable - moveble
distinguish - distnigush
patents - pattents
lb. - elby
sec. - section
therapist - theorpist
damned - damed
murderer - murdere
helion - helian
rousseau - russo
reactivity - ractivity
tetrachloride - tectrochlorid
nonspecific - nonspesific
vertex - vortex
rourke - rork
haney - pany
letch - lash
commented - comented
ridge - rish
privilege - previolage
formally - fomally
committees - commeties
athletic - atheltic
stolen - stollen
deliver - dealiver
proceedings - preseadings
repeatedly - repeadedly
emerge - hemege
compelled - compeled
arkansas - archensaw
juvenile - jvinile
assign - asign
arose - arrose
chorus - corous
talks - tox
announce - anounse
shrugged - strugged
erected - errected
columbia - collembia
ranged - rainged
pronounced - prnounsed
squad - sward
yankee - yankie
bat - bad
tokyo - tokeo
fan - ven
ceremony - seremony
ernie - earny
harvey - hearvy
stein - stine
it'll - idle
knight - nivfe
angel - angle
meredith - marriative
competence - competance
buried - barried
kowalski - covolsky
pole - poll
crops - scropes
emphasized - emphasised
stephen - steaven
investigated - invstigated
abrupt - ubrupt
disposed - desposed
parlor - parlter
assignments - assingments
bishop - beshup
initially - inettialy
mechanisms - mechnaisms
manufacture - manufracture
customs - customes
terribly - terrably
nineteen - 19
religions - relegions
autonomy - atonomy
spectacle - speticle
interrupted - interupted
rubbed - roved
plainly - planely
consistency - consitstancy
bathroom - bathorom
bitterness - bitternets
bulletin - buleten
referring - reffering
sole - soul
hypothesis - hypotheis
refers - reffers
who's - ooz
medieval - bedivle
rod - raud
exercised - exersised
brightness - britment
camping - campting
cylinder - cylender
colt - cold
photograph - phtograph
aluminum - alumenum
printing - printig
ammunition - ammunision
roared - rovered
intuition - intuvision
upton - upten
adolescence - attalesance
griffith - griffef
doctor's - doctors
stall - stoll
saxon - saxen
cobb - cub
abruptly - ubruptly
stevie - stevy
andrei - endrey
kitti - kiddy
madden - madl
langford - lanford
barco - barko
fulton - folden
praise - parise
department's - departments
compensation - compensations
employes - employees
consulted - consolted
superintendent - iperintendent
anonymous - unnonymus
counsel - counsle
pierre - pear
combine - convine
cabinet - cambinate
geneva - geneavea
lao - l
fleet - fleave
useless - usless
raymond - raiment
vicious - vissious
ivory - ivery
visits - vistle
declined - decliend
missionary - meshianry
pays - pase
separation - seperation
eighteen - 1ii
stripped - striped
weary - weiry
tract - stracked
designated - desinated
apartments - appartments
baptist - bathists
dec. - december
graduates - graudates
cleveland - cleaveland
throwing - thorwing
checks - shecks
cracked - cract
shaped - shpaed
barriers - bariors
meadow - betel
holiday - holyday
earth's - earths
awarded - awareded
muttered - mutterd
milton - milten
mortgage - morgage
codes - coats
simms - sims
confession - cnfession
inability - inebility
indifference - indeference
flowing - flowwing
anniston - anestin
carroll - caroll
suicide - stuiside
gambling - ganbling
tracing - trasing
counted - coutned
inquiries - inqueries
chip - ship
connecticut - connetecut
accompanying - companyinh
darling - dorling
acquisition - aquesision
seemingly - seamingly
diplomacy - deplomosy
aggressive - agressive
embassy - embasy
destroying - destoring
artificial - artifitial
chaos - cheos
heroes - heros
possess - posess
frankie - franky
belonged - belongse
vaguely - veagely
continent - conetntent
loudly - loveldy
productivity - produtiviyy
remembering - remenbering
campaigns - compains
formidable - formitable
guerrillas - gorillas
rivers - revers
pastor - paster
neighborhoods - neigphorhoodds
thee - dig
collar - coloer
gap - gamp
christians - chrestions
morale - moral
husband's - husbands
consist - consits
awful - auvful
well-known - wellknon
statue - stues
burma - berma
abandon - abandend
obscure - obsure
uncertainty - uncertainity
infectious - infectis
imaginary - imagienry
benson - venson
absurd - obsured
present-day - presntday
inquiry - enquir
and/or - ensloreor
comparative - comparityve
gonna - hune
ballistic - bulitic
bunks - bungs
whiskey - wiskh
lit - light
frankfurter - fracfidder
respiratory - resporetroy
drug's - drungs
cereal - serial
dandy - dandly
screaming - searming
screamed - seamined
voyage - voage
cops - copes
lizzie - lissy
piazza - peatsa
murmured - murmered
trevelyan - treavlian
krim - crim
thyroglobulin - thirogrovulin
corridor - coretor
odd-lot - ondloat
bod - vod
accelerometer - accelorometer
ada - ata
angie - engie
lalaurie - lollauriy
nadine - nadean
moreland - morland
improving - imporving
fee - vi
sites - sights
boy's - voise
chemistry - chemisty
inquired - enquired
thru - strow
unnecessary - undesseary
ambitious - ambisuous
requiring - requring
explosion - explossing
viet - vieat
invasion - invation
observer - apporver
professors - proessors
severely - severarly
unemployment - unemployement
glow - gow
successor - sucesser
taxi - taxy
government's - goverments
chapters - chaers
commitments - comitments
legitimate - legitemate
adequately - adequetly
montgomery - monthgomery
greece - gerece
delegates - delegatges
strengthen - strenghn
indications - indecations
brooks - borcs
chores - shors
bounced - bounsed
slammed - slamed
nelson - neslson
spotted - spoted
denver - devner
buffalo - buffelo
cherished - sharished
stuart - stoeverd
commit - comit
strings - stranths
cows - coules
they've - dave
earn - urn
gown - gun
byron - viron
commissioners - commitioners
broadcast - broadcasts
flashed - flased
pursuit - persuied
priests - preests
cranston - cranstine
rider - writer
cockpit - cocpit
beautifully - beatifully
fringe - french
vessel - vessle
simplicity - simplisity
composite - compasite
henri - henrey
anthony - antheory
bass - base
persistent - persistant
sins - since
channel - chanell
discussing - descussing
miracle - merricle
partners - parterns
nineteenth-century - 19thcentury
parliament - parlement
vs. - vs
afterward - afterword
excluding - exluding
muscular - musculor
endurance - indurance
philosopher - phylosopher
hammarskjold - hamersheld
soup - shoupe
gradual - graual
maintains - maintaince
bulk - bolk
translate - tanslate
blockade - blocade
sturdy - steady
audiences - audiances
piled - pil;ed
spreading - speading
contents - contancts
